//MAP CONVERTED BY dmm2tgm.py THIS HEADER COMMENT PREVENTS RECONVERSION, DO NOT REMOVE
"a" = (
/turf/template_noop,
/area/template_noop)
"e" = (
/turf/open/floor/pod/dark,
/area/shuttle/arrival)
"h" = (
/obj/structure/chair/comfy/shuttle,
/turf/open/floor/pod/dark,
/area/shuttle/arrival)
"k" = (
/obj/machinery/atmospherics/pipe/simple/scrubbers/hidden/layer3{
	dir = 4
	},
/obj/machinery/atmospherics/pipe/simple/supply/hidden{
	dir = 8;
	icon_state = "pipe11-2"
	},
/turf/open/floor/pod/dark,
/area/shuttle/arrival)
"l" = (
/obj/machinery/atmospherics/pipe/simple/supply/hidden/layer1{
	dir = 4
	},
/turf/open/floor/pod/dark,
/area/shuttle/arrival)
"n" = (
/obj/structure/chair/comfy/shuttle{
	dir = 1
	},
/turf/open/floor/pod/dark,
/area/shuttle/arrival)
"o" = (
/turf/template_noop,
/area/shuttle/arrival)
"q" = (
/obj/machinery/door/airlock/shuttle,
/obj/machinery/atmospherics/pipe/layer_manifold{
	dir = 4
	},
/obj/docking_port/mobile/arrivals{
	dwidth = 2;
	height = 11;
	width = 5
	},
/obj/effect/mapping_helpers/airlock/cyclelink_helper{
	dir = 8
	},
/turf/open/floor/pod/dark,
/area/shuttle/arrival)
"s" = (
/obj/structure/window/reinforced{
	dir = 8
	},
/obj/machinery/atmospherics/components/unary/tank/air{
	dir = 4
	},
/turf/open/floor/pod/dark,
/area/shuttle/arrival)
"w" = (
/obj/machinery/atmospherics/components/binary/dp_vent_pump{
	dir = 4
	},
/obj/machinery/atmospherics/pipe/simple/scrubbers/hidden/layer3{
	dir = 4
	},
/turf/open/floor/pod/dark,
/area/shuttle/arrival)
"y" = (
/turf/closed/wall/mineral/titanium,
/area/shuttle/arrival)
"z" = (
/obj/structure/sign/warning/vacuum/external{
	pixel_y = -32
	},
/turf/open/floor/pod/dark,
/area/shuttle/arrival)
"A" = (
/turf/open/floor/plating/airless,
/area/shuttle/arrival)
"G" = (
/obj/machinery/atmospherics/pipe/layer_manifold{
	dir = 4
	},
/turf/open/floor/pod/dark,
/area/shuttle/arrival)
"N" = (
/obj/machinery/door/airlock/shuttle,
/obj/machinery/atmospherics/pipe/layer_manifold{
	dir = 4
	},
/obj/effect/mapping_helpers/airlock/cyclelink_helper{
	dir = 4
	},
/turf/open/floor/pod/dark,
/area/shuttle/arrival)
"S" = (
/obj/structure/shuttle/engine/huge{
	dir = 8
	},
/turf/template_noop,
/area/shuttle/arrival)
"T" = (
/obj/machinery/advanced_airlock_controller/directional/north{
	locked = 0;
	name = "advanced mining airlock controller";
	req_access = null;
	req_one_access_txt = "48"
	},
/turf/open/floor/pod/dark,
/area/shuttle/arrival)
"W" = (
/obj/structure/chair/comfy/shuttle,
/obj/machinery/light/small{
	dir = 8
	},
/turf/open/floor/pod/dark,
/area/shuttle/arrival)
"Z" = (
/obj/machinery/light/small,
/turf/open/floor/pod/dark,
/area/shuttle/arrival)

(1,1,1) = {"
a
o
A
S
a
"}
(2,1,1) = {"
a
o
A
o
a
"}
(3,1,1) = {"
a
o
A
o
a
"}
(4,1,1) = {"
y
y
s
y
y
"}
(5,1,1) = {"
y
W
G
n
y
"}
(6,1,1) = {"
y
h
l
n
y
"}
(7,1,1) = {"
y
h
l
n
y
"}
(8,1,1) = {"
y
y
N
y
y
"}
(9,1,1) = {"
y
T
w
z
y
"}
(10,1,1) = {"
y
e
k
Z
y
"}
(11,1,1) = {"
y
y
q
y
y
"}
