"a" = (/turf/open/space/basic,/area/space)
"b" = (/obj/machinery/atmospherics/pipe/simple/supply/hidden/layer1{dir = 4},/turf/open/floor/pod/dark,/area/space)
"c" = (/obj/machinery/door/airlock/shuttle,/obj/machinery/atmospherics/pipe/layer_manifold{dir = 4},/turf/open/floor/pod/dark,/area/space)
"i" = (/obj/machinery/door/airlock/shuttle,/turf/open/floor/pod/dark,/area/space)
"l" = (/obj/structure/sign/warning/vacuum/external{pixel_y = -32},/turf/open/floor/pod/dark,/area/space)
"n" = (/obj/structure/chair/comfy/shuttle,/obj/effect/landmark/start/new_player,/turf/open/floor/pod/dark,/area/space)
"o" = (/obj/machinery/advanced_airlock_controller/directional/north{locked = 0; name = "advanced mining airlock controller"; req_access = null; req_one_access_txt = "48"},/turf/open/floor/pod/dark,/area/space)
"t" = (/obj/structure/window/reinforced{dir = 8},/obj/machinery/atmospherics/components/unary/tank/air{dir = 4},/turf/open/floor/pod/dark,/area/space)
"y" = (/obj/machinery/atmospherics/components/binary/dp_vent_pump{dir = 4},/obj/machinery/atmospherics/pipe/simple/scrubbers/hidden/layer3{dir = 4},/turf/open/floor/pod/dark,/area/space)
"E" = (/turf/open/floor/plating/airless,/area/space)
"G" = (/obj/machinery/atmospherics/pipe/layer_manifold{dir = 4},/turf/open/floor/pod/dark,/area/space)
"N" = (/obj/machinery/atmospherics/pipe/simple/scrubbers/hidden/layer3{dir = 4},/obj/machinery/atmospherics/pipe/simple/supply/hidden{dir = 8; icon_state = "pipe11-2"},/turf/open/floor/pod/dark,/area/space)
"O" = (/obj/machinery/door/airlock/shuttle,/obj/machinery/atmospherics/pipe/layer_manifold{dir = 4},/obj/docking_port/mobile/arrivals,/turf/open/floor/pod/dark,/area/space)
"P" = (/obj/structure/chair/comfy/shuttle{dir = 1},/obj/effect/landmark/start/new_player,/turf/open/floor/pod/dark,/area/space)
"U" = (/turf/closed/wall/mineral/titanium,/area/space)
"V" = (/turf/open/floor/pod/dark,/area/space)
"Z" = (/obj/structure/shuttle/engine/huge{dir = 8},/turf/open/space/basic,/area/space)

(1,1,1) = {"
aaaUUUUUUUU
aaaUnnnUoVi
EEEtGbbcyNO
ZaaUPPPUlVi
aaaUUUUUUUU
"}
