"a" = (/turf/template_noop,/area/template_noop)
"e" = (/turf/open/floor/pod/dark,/area/template_noop)
"h" = (/obj/structure/chair/comfy/shuttle,/obj/effect/landmark/start/new_player,/turf/open/floor/pod/dark,/area/template_noop)
"k" = (/obj/machinery/atmospherics/pipe/simple/scrubbers/hidden/layer3{dir = 4},/obj/machinery/atmospherics/pipe/simple/supply/hidden{dir = 8; icon_state = "pipe11-2"},/turf/open/floor/pod/dark,/area/template_noop)
"l" = (/obj/machinery/atmospherics/pipe/simple/supply/hidden/layer1{dir = 4},/turf/open/floor/pod/dark,/area/template_noop)
"n" = (/obj/structure/chair/comfy/shuttle{dir = 1},/obj/effect/landmark/start/new_player,/turf/open/floor/pod/dark,/area/template_noop)
"q" = (/obj/machinery/door/airlock/shuttle,/obj/machinery/atmospherics/pipe/layer_manifold{dir = 4},/obj/docking_port/mobile/arrivals,/turf/open/floor/pod/dark,/area/template_noop)
"s" = (/obj/structure/window/reinforced{dir = 8},/obj/machinery/atmospherics/components/unary/tank/air{dir = 4},/turf/open/floor/pod/dark,/area/template_noop)
"u" = (/turf/closed/wall/mineral/titanium,/area/template_noop)
"w" = (/obj/machinery/atmospherics/components/binary/dp_vent_pump{dir = 4},/obj/machinery/atmospherics/pipe/simple/scrubbers/hidden/layer3{dir = 4},/turf/open/floor/pod/dark,/area/template_noop)
"y" = (/obj/machinery/door/airlock/shuttle,/turf/open/floor/pod/dark,/area/template_noop)
"z" = (/obj/structure/sign/warning/vacuum/external{pixel_y = -32},/turf/open/floor/pod/dark,/area/template_noop)
"A" = (/turf/open/floor/plating/airless,/area/template_noop)
"G" = (/obj/machinery/atmospherics/pipe/layer_manifold{dir = 4},/turf/open/floor/pod/dark,/area/template_noop)
"N" = (/obj/machinery/door/airlock/shuttle,/obj/machinery/atmospherics/pipe/layer_manifold{dir = 4},/turf/open/floor/pod/dark,/area/template_noop)
"S" = (/obj/structure/shuttle/engine/huge{dir = 8},/turf/template_noop,/area/template_noop)
"T" = (/obj/machinery/advanced_airlock_controller/directional/north{locked = 0; name = "advanced mining airlock controller"; req_access = null; req_one_access_txt = "48"},/turf/open/floor/pod/dark,/area/template_noop)

(1,1,1) = {"
aaauuuuuuuu
aaauhhhuTey
AAAsGllNwkq
Saaunnnuzey
aaauuuuuuuu
"}
